000000000000000000000000000000000000000000000000000000000000000000000000000000000000000000000000000000000000000000000000
000000000000000000000000000000000000000000000000000000000000000000000000000000000000000000000000000000000000000000000000
000000000000000000000000000000000000000000000000000000000000000000000000000000000000000000000000000000000000000000000000
000000000000000000000000000000000000000000000000000000000000000000000000000000000000000000000000000000000000000000000000
000000022222000000000000000000000000000000000000000000000000000000000000000000000000000000000000000000000000000000000000
000000000000000000000000000000000000000000000000000000000000000000002000000000000000000000000000000000000000000000000000
220000000000000002200000022000000000000000000000000000000000000022222000000000000000000000000000000000000000000000000000
112222222222222221100002211222222220000022220000000222220000000000000000000000000000000000000000000000000000000000000000
111111111111111111100001111100000000000000000000000000000000000000000000000000000000000000000000000000000000000000000000
111111111111111111100000110000000000000000000000000000000000000000000000000000000000000000000000000000000000000000000000
111111111111111111100000100000000000000000000000000000000000000000000000000000000000000000000000000000000000000000000000
111111111111111111100000100000000000000000000000000000000000000000000000000000000000000000000000000000000000000000000000
111111111111111111100000000000000000000000000000000000000000000000000000000000000000000000000000000000000000000000000000
