00000000000000000000000000000000000000000000000000000000000000000000000000000000000000000000000000000000000000000000000000000000000222222
00000000000000000000000000000000000000000000000000000000000000000000000000000000000000000000000000000000000000000000000000000000000222222
00000000000000000000000000000000000000000000000000000000000000000000000000000000000000000000000002222000000000000000000000000000000222222
00000000000000000000000000000000000000000000000000000000000000000000000000000000000000000000000000000000000000000000000000000000000222222
00000002222200000000000000000000000000000000000000000000000000000000000000000000000002222200000000000000000000000000000000000000000222222
00000000000000000000000000000000000000000000000000000000000000000000200000001111000000000002222220000000000000000000000000000000000222222
22000000000000000220000002200000000000000000000000000000000000002222200000000000000000000000000000022222000000000000000000000000000222222
11222222222222222110000221122222222000002222000000022222000000000000000000000000000000000000000000000000000000000000000000000000000222222
11111111111111111110000111110000000000000000000000000000000000000000000000000000000000000000000020000000000000000000000000000000000222222
11111111111111111110000011000000000000000000000000000000000000000000000000000000000000000000000022222200000000000000000000000000002222222
11111111111111111110000010000000000000000000000000000000000000000000000000000000000000000000000000000000000000000000000000000000022222222
11111111111111111110000010000000000000000000000000000000000000000000000000000000000000000000000000000000000000000000000000000000022222222
11111111111111111110000000000000000000000000000000000000000000000000000000000000000000000000000000000000000000000000000000000000002222222
11111111111111111110000000000000000000000000000000000000000000000000000000000000000000000000000000000000000000000000000000000000000000000
11111111111111111110000000000000000000000000000000000000000000000000000000000000000000000000000000000000000000000000000000000000000000000
11111111111111111110000000000000000000000000000000000000000000000000000000000000000000000000000000000000000000000000000222222222222222fff