0000000000000000000000000000000000000000000000000000000000000000000000000000000000000000000000000000000000000000000000000000e0000000000000000000000000000000000000000000000000000000000000000000000000000000000000000000000000000000000000000000000000000000000000000000000000000000000000000000000000000000000000000000000
000000000000000000000000000000000000000000000000000000000000000000000000000000000000000000000000000000000000000000000000000000000000000000000000000000000000000000000000000000000000e00000000000000000000000000000000000000000000000000000000000000000000000000000000000000000000000000000000000000000000000000000000000000
0000000000000000000000000000000000000000000000000000000000000000000000000000000000000000000000000acd00000000000000000000000000000000000000000000000000000000000000000000000000000000000000000000000000000000000000000000000000000000000000000000000000000000000000000000000000000000000000000000000000000000000000000000000
000000000000000000000000000000000000000000000000000000000000000000000000000000000000000000000000000000000000000000000000000000000000000000000000000000000000000000000000000000000000000000000000000000000000000000000000000000000000000000000000000000000000000000000000000000000000000000000000000000000000000000000000000
0000000322240000000000000000000000000000000000000000000000000000000000000000000000000abcd0000000000000000000000000000000000000000000000000000000000000000000000000000000000000000000000000000000000000000000000000000000000000000000000000000000000000000000000000000000000000000000000000000000000000000000000000000000000
0000000000000000000000000000000000000000000000000000000000000000000000000000abcd00000000000abbcd0000000000000000000000000000000000000000000000000000000000000000abbbbbbcd00000000000000000000000000000000000000000000000000000000000000000000000000000000000000000000000000000000000000000000000000000000000000000000000000
3200000000000000024000000000000000000000e000000000000000000000abcd0000000000000000000000000e00000abcd00000000000000000000000000000000000000000000000000000000000000000000000000000000000abcd000000000000000000000000000000000000000000000000000000000000000000000000000000000000000000000000000000000000000000000000000000
01222222222222222100000322222222224000003224000000032224000000000000000000000000000000000000000000000000000000000000000000000000000000000000abbbbbbbbbcd0000000000000000000000000000000000000000000000000032400000000000000000000000000000000000000000000000000000000000000000000000000000000000000000000000000000000000000
0111111111111111110000001111e0000000000000000000000000000000000000000000000000000000000000000000324000000000000000000000000000000000000000000000000000000000abbbbbbbbbbbbbbcd0000000000000000000000000000011100000000000000000000000000000000000000000000000000000000000000000000000000000000000000000000000000000000000000
011111111111111111000000010000000000000000000000000000000000000000000000000000000000000000000000322224000000000000000000000000000000000000000000000000000000000000000000000000000000000000000000000000000011100000000000000000000000000000000000000000000000000000000000000000000000000000000000000000000000000000000000000
0011111111111110000000000000000000000000000000000000000000000322222222222224000000000000000000000000000000000000000000000000322222222222400322222222240000000000000000000000000000000000000000000000322222112222222400abbbbbbbbbcd0000000000000000000000000000000000000000000000322222222222222224fff0000000000000000000000
000000000000000000322222222222222222222222222222222222224000000000000000000322222222222222222222222222222222222222224000000000003111110000000003111112222222400000000000000000032222222222222222222221111111111111400000000000000000032222222222400000000000000000032222222222222111111111111111122222224000000000000000000
000000000000000000000000000000000000000000000000000000000000000000000000000000031111111111111111111111111111114000000000000000000311112222222222111111111111222222222222222222222222222222222211111111111111111111222222222222222222221111111111222222222222222222221111111111111111111111111111111111112400000000000000000
000000000000000000000000000000000000000000000000000000000000000000000000031111111111111111114000000000000000e00000000000000000000000000000000000000000000000000000000000000000000000000000000000e00000000000000000000000000000000000000000000000000000000000000000000000000000000000000000000000000000000000000000000000000
000000000000000000000000000000000000000000000000000000000000000000000000000000000000000000000000000000000000000000000000000000000003222222222222222400000000000000000000000000000000000000000000000000000000000000000000000000000000000000000000000000000000000000000000000000000000000000000000000000000000000000000000000