00000000000000000000000000000000000000000000000000000000000000000000000000000000000000000000000000000000000000000000000000000000000222222
00000000000000000000000000000000000000000000000000000000000000000000000000000000000000000000000000000000000000000000000000000000000222222
00000000000000000000000000000000000000000000000000000000000000000000000000000000000000000000000002222000000000000000000000000000000222222
00000000000000000000000000000000000000000000000000000000000000000000000000000000000000000000000000000000000000000000000000000000000222222
00000003222400000000000000000000000000000000000000000000000000000000000000000000000002222200000000000000000000000000000000000000000222222
00000000000000000000000000000000000000000000000000000000000000000000200000001111000000000002222220000000000000000000000000000000000222222
320000000000000002400000e22000000000000000e0000000000000000000002222200000000000000000000000000000022222000000000000000000000000000222222
01222222222222222100000321122222224000003224000000022222000000000000000000000000000000000000000000000000000000000000000000000000000222222
01111111111111111100000011110000000000000000000000000000000000000000000000000000000000000000000020e00000000000000000000000000000000222222
01111111111111111100000011000000000000000000000000000000000000000000000000000000000000000000000022222200000000000000000000000000002222222
0011111111111110000000000000000000000000000000000000000000000321111111111111114<0000000000000000000000000000000000000000000000000002222222
0001111111111110000000000000000000000000000000000000000000031111111111111111111140000000000000000000000000000000000000000000000000000000
0000111111111100000000000000000000000000000000000003111111111111111111111111111111111111140000000000000000000000000000000000000000000000
00000001111100000000000000000000000000000000000000000000000000000000000000000000000000000000000000000000000000000000000222222222222222fff